......................................
......................................
.....############################.....
..................#...................
..................#...................
..................#...................
..................#...................
..................#...................
..................#...................
..................#...................
..................#...................
..................#...................
..................#...................
..................#...................
..................#...................
..................#...................
..................#...................
..................#...................
..................#...................
..................#...................
..................#...................
..................#...................
..................#...................
..................#...................
..................#...................
..................#...................
..................#...................
..................#...................
..................#...................
..................#...................
..................#...................
..................#...................
.....############################.....
......................................
......................................
......................................
......................................
......................................
########################################
......................................