######################################
#....................................#
#....................................#
#....................................#
#....................................#
#....................................#
#....................................#
#....................................#
#....................................#
#....................................#
#....................................#
#....................................#
#....................................#
#....................................#
#....................................#
#....................................#
#....................................#
#....................................#
#....................................#
#....................................#
#....................................#
#....................................#
#....................................#
#....................................#
#....................................#
#....................................#
#....................................#
#....................................#
#....................................#
#....................................#
#....................................#
#....................................#
#....................................#
#....................................#
#....................................#
#....................................#
#....................................#
######################################
########################################
......................................