......###########################.....
......................................
......###########################.....
...#..................................
...#..................................
...#..................................
...#..................................
...#..................................
...#..................................
...#..................................
...#................#.................
...#................#.................
...#................#.................
...#................#.................
...#................#.................
...#................#.................
...#................#.................
...#................#.................
...#................#.................
...#..###########################.....
....................#.................
....................#.................
....................#.................
....................#.................
....................#.................
....................#.................
....................#.................
....................#.................
....................#.................
......................................
......###########################.....
......................................
......###########################.....
...............................X......
......................................
......................................
......................................
......................................
########################################
......................................

